---#--###------#
-#---#----##----
####-#-#-#-##---
---#---#-#------
-#-####---##----
-#------#-------
-###############
------------###@
-----------#----